##|#####|###|#####|###  |       |   |   |
+#+#+-+#+#+#+#+-+#+#+#+ + +-+-+ + + + + +
|###|  ###|###|  ###|#| | |       |   | |
+-+-+ +-+-+-+-+ +-+-+#+-+ + +-+-+-+-+-+ +
|   | |   |     |  ###|   |   |   |   | |
+ + + + + + +-+-+ +#+-+ +-+-+ + + + + +-+
| |   | | | |   | |###| | |   | |   |   |
+ +-+-+-+ + +-+ + +-+#+ + + +-+ + +-+-+ +
|         |     |   |#| |   |   |   |   |
+-+-+-+-+-+-+-+-+-+-+#+ +-+-+ + +-+-+ + +
|         |   |   |###| |###| | |     | |
+ +-+-+-+ + + + + +#+-+ +#+#+-+ + +-+-+ +
|   |   | | |   | |#######|#|   |     | |
+-+ + +-+ + +-+-+ +-+-+-+-+#+ +-+-+-+ + +
|   | |   |     | |   |   |#| |       | |
+ +-+ + +-+-+-+ +-+ + + + +#+ +-+-+-+-+ +
|     |           | |   |###|   |       |
+-+-+-+-+-+-+-+ + + +-+-+#+-+-+ + +-+-+-+
| |     |       |   |    #| |   |       |
+ + +-+ + +-+-+-+-+-+ +-+#+ + +-+-+-+-+ +
| | |     |         | |###|  #####|   | |
+ + + +-+-+-+ +-+-+ + +#+-+-+#+-+#+ + +-+
|   |   |     |   | | |#######|###| |   |
+-+-+-+-+ +-+-+ + + + +-+-+-+-+#+-+-+-+ +
|   |     |     | |   |     |###|     | |
+-+ + +-+-+-+-+ + +-+-+ +-+ +#+-+ +-+ + +
|   |       |   |       |   |###| |   | |
+ +-+-+-+-+ + +-+-+-+ + + +-+-+#+ +-+ + +
| |   |     |     |   | |      #####| | |
+ + + + +-+-+-+-+ + +-+-+-+-+-+ + +#+ + +
|   |   |         | |   |       | |#| | |
+-+-+-+-+ +-+-+-+-+ +-+ +-+-+-+-+-+#+ + +
|             |   |   |   | |#######| | |
+ +-+-+-+-+-+ + +-+-+ +-+ + +#+-+-+-+ + +
|   |     |   |     |     | |#|     | | |
+-+ + +-+ +-+-+-+-+ +-+-+-+ +#+-+-+ + + +
|   |   |   |     |  #########|###| |   |
+ +-+-+ + + + +-+ +-+#+-+-+-+-+#+#+ +-+-+
|       | |   |   |  ###########|########
+-+-+-+-+-+-+-+-+-+-+-+-+-+-+-+-+-+-+-+-+