  |     |   |     |     |       |   |   |
+ + +-+ + + + +-+ + + + + +-+-+ + + + + +
|   |     |   |     | | | |       |   | |
+-+-+ +-+-+-+-+ +-+-+ +-+ + +-+-+-+-+-+ +
|   | |   |     |     |   |   |   |   | |
+ + + + + + +-+-+ + +-+ +-+-+ + + + + +-+
| |   | | | |   | |   | | |   | |   |   |
+ +-+-+-+ + +-+ + +-+ + + + +-+ + +-+-+ +
|         |     |   | | |   |   |   |   |
+-+-+-+-+-+-+-+-+-+-+ + +-+-+ + +-+-+ + +
|         |   |   |   | |   | | |     | |
+ +-+-+-+ + + + + + +-+ + + +-+ + +-+-+ +
|   |   | | |   | |       | |   |     | |
+-+ + +-+ + +-+-+ +-+-+-+-+ + +-+-+-+ + +
|   | |   |     | |   |   | | |       | |
+ +-+ + +-+-+-+ +-+ + + + + + +-+-+-+-+ +
|     |           | |   |   |   |       |
+-+-+-+-+-+-+-+ + + +-+-+ +-+-+ + +-+-+-+
| |     |       |   |     | |   |       |
+ + +-+ + +-+-+-+-+-+ +-+ + + +-+-+-+-+ +
| | |     |         | |   |       |   | |
+ + + +-+-+-+ +-+-+ + + +-+-+ +-+ + + +-+
|   |   |     |   | | |       |   | |   |
+-+-+-+-+ +-+-+ + + + +-+-+-+-+ +-+-+-+ +
|   |     |     | |   |     |   |     | |
+-+ + +-+-+-+-+ + +-+-+ +-+ + +-+ +-+ + +
|   |       |   |       |   |   | |   | |
+ +-+-+-+-+ + +-+-+-+ + + +-+-+ + +-+ + +
| |   |     |     |   | |           | | |
+ + + + +-+-+-+-+ + +-+-+-+-+-+ + + + + +
|   |   |         | |   |       | | | | |
+-+-+-+-+ +-+-+-+-+ +-+ +-+-+-+-+-+ + + +
|             |   |   |   | |       | | |
+ +-+-+-+-+-+ + +-+-+ +-+ + + +-+-+-+ + +
|   |     |   |     |     | | |     | | |
+-+ + +-+ +-+-+-+-+ +-+-+-+ + +-+-+ + + +
|   |   |   |     |           |   | |   |
+ +-+-+ + + + +-+ +-+ +-+-+-+-+ + + +-+-+
|       | |   |   |             |        
+-+-+-+-+-+-+-+-+-+-+-+-+-+-+-+-+-+-+-+-+
